##################################################
##...............#...............................#
#.........##E....................................#
#...............#................................#
#..............#.................................#
#...........#..........#...............#.........#
#.............#..................................#
#..................#.............................#
#..........#...............#....#................#
#.#...............#...................#..........#
#............#....#..............................#
#...........#.........#..........................#
#................#...............................#
#................................................#
#...#............................................#
#..........................................#.....#
#............#...................................#
#..#............#................................#
#........#....#..................................#
#..........#..............................#......#
#.........................#......................#
#..............................#.................#
#...............................................##
#......................................S.........#
#.......#........................................#
#.............................#..................#
#......#.........................................#
#....................................#...........#
#............................#...................#
##################################################