##################################################
##.......................................#.......#
#............#...................................#
#.....#.#........................................#
#...........#....#........#..................#...#
#.......#...........#.....................#......#
#..............#.................................#
#...............#................................#
#....#..........................................##
#..................#.............................#
#................................................#
#.........................S......................#
#......#.........................................#
#........#........#...............#..............#
#................................................#
#..#..#..........................................#
#.........#...#...............#..................#
#...#.............#........#..........#..........#
#.....#....#...............................E#....#
#...........................................#....#
#................................#...............#
#........................##.............#........#
#................................#...#...........#
#....#...........................................#
#.....................................#..#.......#
#...#........#...................................#
#.#......#...................#.............##....#
#.......#.......................#...............##
#.......................#........................#
##################################################