##################################################
#................................................#
#........#.......................................#
#.......................................#........#
#.................#..............................#
#.........................#......................#
#................................................#
#........S.......................................#
#................................................#
#................................................#
#................................................#
#.............................................#..#
#...............................................E#
#.......................#........................#
#................................................#
#................................................#
#......................#.........................#
#........................#.......................#
#................#...............................#
#......................................#.........#
#................................................#
#................................................#
#............................................#...#
#...............................................##
#................................................#
#................................................#
#................................................#
#................................................#
#................................................#
##################################################