##################################################
#...........................................#....#
#.............#..................................#
#................................................#
#................................................#
#................#...............................#
#..........................#.....................#
#................................................#
#................................................#
#................S...............................#
#................#...............................#
#..........#..........................E#.........#
#......................................#.........#
#...............#................................#
#...............................................##
#................................................#
#............#...................................#
#.....................................#..........#
#................................................#
#................................................#
#................................................#
#.........#......................................#
#..........................................#.....#
#................................................#
#................................................#
#....................#...........................#
#.........................#......................#
#................................................#
#................................................#
##################################################