##################################################
#................................................#
#........#.......................................#
#.......................................#........#
#.................#..............................#
#.........................#......................#
#................................................#
#................................................#
#...............................E................#
#................................................#
#................................................#
#.............................................#..#
#................................................#
#.......................#........................#
#................................................#
#................................................#
#......................#........S................#
#........................#.......................#
#................#...............................#
#......................................#.........#
#................................................#
#................................................#
#............................................#...#
#...............................................##
#................................................#
#................................................#
#................................................#
#................................................#
#................................................#
##################################################